action,cold,warm,prewarm,create,rent,queue
eo_ons3objectcreated,3,27426,0,3,0,27426
eo_gluerunner,6,27423,0,6,2,27421
eo_athenarunner,2,27427,0,2,0,27427
fmp_twitter_streaming,5,20358,0,5,0,20358
sc_update_cart,1,3141,0,1,2,3139
sc_add_to_cart,1,3141,0,1,1,3140
sc_checkout_cart,1,3141,0,1,1,3140
sc_list_cart,1,3141,0,1,2,3139
sc_migrate_cart,1,3141,0,1,1,3140
fmp_twitterddb,5,20358,0,5,1,20357
fmp_comparefaces,5,20358,0,5,0,20358
sc_delete_from_cart,1,3141,0,1,1,3140
tcp_download_podcast,2,1370,0,2,0,1370
cs_bot,1,1427,0,1,6,1421
df_union,1,1518,0,1,2,1516
tcp_check_transcribe,3,1368,0,3,0,1368
tcp_process_podcast_rss,4,1367,0,4,3,1364
tcp_upload_to_elasticsearch,2,1370,0,2,0,1370
cer_lambda,1,73,0,1,0,73
t_payment_method,0,209,0,0,1,208
t_ddb_encrypt_item,0,209,0,0,1,208
fp_notification,2,4,0,2,4,0
fp_conversion,1,5,0,1,5,0
fp_sentiment,0,6,0,0,6,0
ep_users_sign_up,1,15,0,1,5,10
ep_orders_create_order,0,16,0,0,6,10
ep_products_table_update,1,15,0,1,5,10
ep_delivery_on_package_created,0,16,0,0,6,10
ep_payment_validate,3,13,0,3,3,10
ep_products_validate,0,16,0,0,6,10
ep_warehouse_on_order_events,1,15,0,1,5,10
ep_warehouse_table_update,1,15,0,1,5,10
ep_payment_cancel_payment,1,15,0,1,5,10
ep_orders_table_update,0,16,0,0,6,10
ep_delivery_table_requests,0,16,0,0,6,10
ep_payment_update_payment,2,14,0,2,4,10
ep_orders_on_event,2,14,0,2,4,10
ep_payment_process_payment,1,15,0,1,5,10
