action,cold,warm,prewarm,create,rent,queue
sc_migrate_cart,2,3140,1,2,0,3139
sc_list_cart,1,3141,6,1,0,3135
sc_checkout_cart,0,3142,4,0,0,3138
sc_update_cart,2,3140,5,2,0,3135
sc_add_to_cart,1,3141,2,1,0,3139
fmp_twitter_streaming,10,20353,3,10,0,20350
eo_athenarunner,7,27422,1,7,0,27421
eo_gluerunner,10,27419,5,10,0,27414
eo_ons3objectcreated,10,27419,5,10,0,27414
sc_delete_from_cart,2,3140,1,2,0,3139
fmp_twitterddb,10,20353,0,10,0,20353
fmp_comparefaces,10,20353,1,10,0,20352
tcp_download_podcast,3,1369,4,3,0,1365
tcp_check_transcribe,4,1368,3,4,0,1365
df_union,2,1517,8,2,0,1509
cs_bot,0,1428,7,0,0,1421
tcp_process_podcast_rss,4,1368,8,4,0,1360
tcp_upload_to_elasticsearch,5,1367,5,5,0,1362
cer_lambda,0,74,1,0,0,73
t_payment_method,0,209,3,0,0,206
t_ddb_encrypt_item,0,209,3,0,0,206
fp_notification,0,6,6,0,0,0
fp_conversion,4,2,2,4,0,0
fp_sentiment,2,4,4,2,0,0
ep_orders_create_order,2,14,4,2,0,10
ep_users_sign_up,3,13,3,3,0,10
ep_products_table_update,1,15,5,1,0,10
ep_products_validate,5,11,1,5,0,10
ep_delivery_on_package_created,3,13,3,3,0,10
ep_payment_validate,4,12,2,4,0,10
ep_warehouse_on_order_events,5,11,1,5,0,10
ep_warehouse_table_update,3,13,3,3,0,10
ep_delivery_table_requests,5,11,1,5,0,10
ep_orders_table_update,5,11,1,5,0,10
ep_payment_cancel_payment,3,13,3,3,0,10
ep_payment_update_payment,2,14,4,2,0,10
ep_payment_process_payment,5,11,1,5,0,10
ep_orders_on_event,4,12,2,4,0,10
